2 3
.#.
...
1


5 6
..##..
.#..#.
....##
.##.##
......
3


2 2
.#
#.
0


2 2
..
..
1


8 8
.#....#.
.#.....#
.#.##..#
.......#
..##....
.#...#..
.##...##
##......
1


2 3
..#
#..
0


3 3
..#
#.#
#..
0


1 2
..
0


8 8
........
........
........
........
........
........
........
........
2


30 30
..........#........#.........#
#.#.#####.####.###.#..######.#
#.#.......#..#.#.#.##.#....#..
..#.###.#.##.#.....#..#.#.##.#
.#..#.#.#.##.#.######.###.##.#
.#.#..#....#..................
.#.#.#####.#.#.########.#####.
.#.#.......#.#.#.#....#.#...#.
.#.#########.#...#.##.#...#.#.
.#...........#.#.#..#########.
.###########.###.##.#.........
....................#.#.####.#
######.##########.#.#.#.#....#
.......#.....#....###.#.#.##.#
.#####.##.#####.##....#...#...
.#..............##.#####.#####
.#########.#######.#...#....#.
.................#.###.####.#.
#.#######.#.#.####.....#......
...#.#..###.##.....########.#.
.#.#....#.#..#.###.#...#.#####
.#.#.##.#.#.##.#....#.#...#...
##....#.#.#.#..#.#.#####.####.
.#.######.######.#.#.#........
............#....#.#.#.#####.#
#####.#######.####.#.#....#..#
......#..........#.....##.#.##
.##############.#####.#.#.#.#.
.#...........##.#...#.#.#.#.#.
.#.##.######....#.#...#...#...
1
